SSSUUUUUUUOUUUUOOUUU
SSSUUUUUUUOUUUUOUUUU
SSSUUUUUUUOUUUUOUUUU
UUUUUUUUUUOOUUUOUUUU
UUUUUOUUUUUUUUUUUUUU
UUUUUOUUUUUUUUUUUUUU
UUUUUOUUUUUUUUUUUUUO
UUUUUOUUUUUUUUOOUUUU
UUUUUOUUUUUUUUOUUUUU
UUUUUOUUUUUUOOOUUUUU
UUUUUUUUUUUUUUUUUUUU
UUUUUUUUUUUUUUUUUUUU
UUUUUUUUUUUUUUUUUEEE
UUUUOUUUUUUUUUUUUEEE
UUUUOOOOUUUUUOOUUEEE